wwwwwwwwwwwwwwwwwwwwwwwwwwww
w.........A................w
w..........................w
w..........................w
w..........................w
wwwwwwwwwwwww.wwwwwwwwwwwwww
w..........................w
w.....1...1.1..1...........w
w........................0.w
w....1..1..1...........0...w
w......................0...w
wwwwwwwwwwwwwwwwwwwwwwwwwwww