wwwwwwwwwwwwwwwwwwwwwwwwwwww
w..0.....0..w...0.0.0.0w000w
w.0....................w000w
w...0...0.....A........w000w
wwwwwwwwwwww.............00w
w0..................w.....ww
w0......0..................w
w0.........wwwww....0.....0w
wwwww................w.....w
w........0.0.0.0.0...w0...0w
wwwwwwwwwwwwwwwwwwwwwwwwwwww