wwwwwwwwwwwwwwwwwwwwwwwwwwwwwwww
w3ssssslsssssssssslslsssssssss2w
ws......................00000.sw
ws00..........................sw
ws00..........................sw
wd00..........................uw
wd00...........A..............sw
ws............................sw
ws............................sw
ws00..........................uw
ws00.....................00000sw
ws.0.....................0000.sw
w4sssssssrsssssssssrssssssssss1w
wwwwwwwwwwwwwwwwwwwwwwwwwwwwwwww
