wwwwwwwwwwwwwwwwwwwwwwwwwwwwwwww
w3sllsslsssllsslslsslsllslssll2w
wd.0.......000.....00...00000.sw
wd00.......000..............00uw
ws..........................00sw
wd00..........................uw
wd00...........A..............sw
ws00..........................uw
ws..........................00sw
ws00........................00uw
ws00.........00000..........00uw
ws.0......00.00000.00....0000.uw
w4ssrrrrsrssrssrsrrssrsrsssrss1w
wwwwwwwwwwwwwwwwwwwwwwwwwwwwwwww
