wwwwwwwwwwwwwwwwwwwwwwww
w..3.ww.......3.ww....Aw
w....w..........w......w
w.w.....wwww.w.....wwwww
w+w........1.w........1w
w.w..wwwwwww.w..wwwwwwww
w.......w..........w...w
w...2w....w....2w....wgw
wwwwwwwwwwwwwwwwwwwwwwww
