wwwwwwwwwwwwwwwwwwwwwwww
w.3.gw....1..3..w....1.w
w..www........www......w
w..........2...w......2w
w.......wwww...w...wwwww
w.......w......w...w+..w
w...w...w......w...w...w
wA..w..........w.......w
wwwwwwwwwwwwwwwwwwwwwwww
