wwwwwwwwwwwwwwwwwwwwwwww
w.....................gw
w....w..........w......w
w.w.w..1.......w..1....w
w+w....................w
ww1..2..3....1..2..3...w
w..w..w.w.w.w.w.w.w.w..w
w...A..................w
wwwwwwwwwwwwwwwwwwwwwwww
