wwwwwwwwwwwwwwwwwwwwwwww
wA.......w..........w..w
w..w....w.....ww.......w
w...w...w.+w...w...w..ww
www.w2..wwwwwwww1..wwwww
w.......w......wwwww.g.w
w.2..........3.........w
w.....2..........2.....w
wwwwwwwwwwwwwwwwwwwwwwww