wwwwwwwwwwwwwwwwwwwwwwww
w....w...............g.w
w...www........www.....w
w.2..www.....2..www....w
w..wwwwwww....wwwwwww..w
w......w........w.w....w
w....w...2......w...2..w
wA...w+...1.....w....1.w
wwwwwwwwwwwwwwwwwwwwwwww
